####################
#                  #
#                  #
#                  #
#       S          #
#                  #
#    ########      #
#          E       #
####################
